//MAP CONVERTED BY dmm2tgm.py THIS HEADER COMMENT PREVENTS RECONVERSION, DO NOT REMOVE
"a" = (
/turf/open/floor/plating,
/area/template_noop)
"b" = (
/obj/effect/decal/cleanable/blood,
/turf/open/floor/plating,
/area/template_noop)
"c" = (
/obj/structure/disposalpipe/loafer,
/turf/open/floor/plating,
/area/template_noop)
"e" = (
/obj/effect/turf_decal/arrows/red{
	dir = 1
	},
/turf/open/floor/plating,
/area/template_noop)

(1,1,1) = {"
a
a
a
"}
(2,1,1) = {"
b
c
e
"}
(3,1,1) = {"
a
a
a
"}
