//MAP CONVERTED BY dmm2tgm.py THIS HEADER COMMENT PREVENTS RECONVERSION, DO NOT REMOVE
"cQ" = (
/obj/structure/pool/Rboard,
/obj/effect/decal/cleanable/dirt/dust,
/turf/open/floor/plasteel/yellowsiding{
	dir = 8
	},
/area/template_noop)
"fv" = (
/obj/item/reagent_containers/glass/waterbottle/empty,
/turf/open/pool,
/area/template_noop)
"iU" = (
/obj/machinery/pool/drain,
/obj/item/trash/candy,
/turf/open/pool,
/area/template_noop)
"jq" = (
/obj/effect/decal/cleanable/dirt/dust,
/obj/effect/decal/cleanable/glass,
/turf/open/floor/plasteel/yellowsiding{
	dir = 1
	},
/area/template_noop)
"jD" = (
/obj/item/trash/candy,
/turf/open/pool,
/area/template_noop)
"nO" = (
/obj/effect/decal/cleanable/dirt/dust,
/turf/open/floor/plasteel/yellowsiding/corner{
	dir = 1
	},
/area/template_noop)
"pF" = (
/obj/effect/decal/cleanable/dirt/dust,
/turf/open/floor/plasteel/yellowsiding{
	dir = 4
	},
/area/template_noop)
"qI" = (
/obj/machinery/pool/controller,
/turf/open/floor/plating,
/area/template_noop)
"ra" = (
/obj/machinery/pool/filter{
	pixel_y = -17
	},
/turf/open/floor/plating,
/area/template_noop)
"rn" = (
/obj/effect/decal/cleanable/dirt/dust,
/obj/item/toy/poolnoodle/yellow,
/turf/open/floor/plasteel/yellowsiding/corner{
	dir = 8
	},
/area/template_noop)
"rq" = (
/obj/effect/decal/cleanable/blood/gibs,
/turf/open/floor/plasteel/yellowsiding{
	dir = 1
	},
/area/template_noop)
"rC" = (
/obj/effect/decal/cleanable/dirt,
/obj/effect/decal/cleanable/glass,
/turf/open/floor/plasteel/yellowsiding{
	dir = 4
	},
/area/template_noop)
"rW" = (
/turf/open/pool,
/area/template_noop)
"te" = (
/obj/item/trash/pistachios,
/turf/open/pool,
/area/template_noop)
"un" = (
/turf/open/floor/plasteel,
/area/template_noop)
"uB" = (
/obj/item/trash/can,
/turf/open/pool,
/area/template_noop)
"uZ" = (
/turf/open/floor/plasteel/yellowsiding{
	dir = 8
	},
/area/template_noop)
"xq" = (
/turf/open/floor/plasteel/yellowsiding/corner{
	dir = 4
	},
/area/template_noop)
"xX" = (
/obj/structure/pool/ladder{
	dir = 2;
	pixel_y = 19
	},
/turf/open/pool,
/area/template_noop)
"zY" = (
/obj/effect/decal/cleanable/dirt/dust,
/obj/effect/decal/remains/human,
/turf/open/floor/plasteel/yellowsiding{
	dir = 1
	},
/area/template_noop)
"As" = (
/obj/structure/pool/ladder,
/turf/open/pool,
/area/template_noop)
"AE" = (
/obj/effect/decal/cleanable/blood/gibs/core,
/turf/open/floor/plating,
/area/template_noop)
"BC" = (
/obj/effect/decal/cleanable/dirt/dust,
/obj/effect/decal/cleanable/glass,
/turf/open/floor/plasteel/yellowsiding{
	dir = 4
	},
/area/template_noop)
"Ch" = (
/turf/open/floor/plating,
/area/template_noop)
"Dj" = (
/obj/item/trash/cheesie,
/turf/open/pool,
/area/template_noop)
"Dq" = (
/turf/open/floor/plasteel/yellowsiding,
/area/template_noop)
"FJ" = (
/obj/effect/decal/cleanable/dirt,
/obj/item/toy/poolnoodle/red,
/turf/open/floor/plasteel/yellowsiding{
	dir = 4
	},
/area/template_noop)
"FQ" = (
/obj/effect/decal/cleanable/blood/gibs,
/turf/open/floor/plasteel/yellowsiding,
/area/template_noop)
"Ic" = (
/obj/effect/decal/cleanable/dirt/dust,
/turf/open/floor/plasteel,
/area/template_noop)
"Li" = (
/obj/structure/pool/ladder{
	dir = 1;
	pixel_y = -25
	},
/turf/open/pool,
/area/template_noop)
"NP" = (
/obj/effect/decal/remains/human,
/turf/open/floor/plasteel/yellowsiding,
/area/template_noop)
"NS" = (
/turf/open/floor/plasteel/yellowsiding{
	dir = 1
	},
/area/template_noop)
"PV" = (
/obj/effect/decal/cleanable/glass,
/turf/open/floor/plating,
/area/template_noop)
"Rn" = (
/obj/item/trash/cheesie,
/obj/item/trash/pistachios,
/turf/open/pool,
/area/template_noop)
"TZ" = (
/obj/item/trash/chips,
/turf/open/pool,
/area/template_noop)
"Vd" = (
/obj/effect/decal/cleanable/dirt/dust,
/turf/open/floor/plasteel/yellowsiding/corner,
/area/template_noop)
"Wc" = (
/obj/structure/pool/Lboard,
/turf/open/pool,
/area/template_noop)

(1,1,1) = {"
un
Ic
un
un
Ch
Ch
Ch
Ch
Ch
Ch
"}
(2,1,1) = {"
un
Vd
AE
BC
Ch
rC
FJ
pF
xq
Ch
"}
(3,1,1) = {"
un
FQ
Dj
uB
As
rW
rW
fv
zY
Ch
"}
(4,1,1) = {"
un
ra
rW
Dj
rW
jD
rW
rW
PV
un
"}
(5,1,1) = {"
Ch
Dq
xX
Rn
te
iU
jD
rW
jq
Ch
"}
(6,1,1) = {"
Ch
qI
rW
rW
rW
rW
jD
Li
PV
Ch
"}
(7,1,1) = {"
Ch
PV
rW
rW
rW
rW
rW
TZ
rq
un
"}
(8,1,1) = {"
Ic
NP
fv
rW
Wc
rW
TZ
uB
NS
Ic
"}
(9,1,1) = {"
Ch
rn
Ch
Ch
cQ
uZ
uZ
PV
nO
Ch
"}
(10,1,1) = {"
Ch
Ch
un
Ic
Ch
Ch
Ic
un
Ch
Ch
"}
