//MAP CONVERTED BY dmm2tgm.py THIS HEADER COMMENT PREVENTS RECONVERSION, DO NOT REMOVE
"a" = (
/turf/template_noop,
/area/template_noop)
"d" = (
/obj/structure/fans/tiny,
/obj/machinery/door/airlock/external,
/turf/open/floor/mineral/titanium,
/area/shuttle/arrival)
"e" = (
/obj/effect/turf_decal/stripes/line{
	dir = 9
	},
/obj/structure/closet/crate/internals,
/turf/open/floor/mineral/plastitanium,
/area/shuttle/arrival)
"h" = (
/obj/structure/shuttle/engine/heater,
/obj/structure/window/reinforced/spawner/north,
/turf/open/floor/plating,
/area/shuttle/arrival)
"k" = (
/obj/machinery/light{
	dir = 8
	},
/turf/open/floor/mineral/titanium,
/area/shuttle/arrival)
"l" = (
/obj/effect/spawner/structure/window/shuttle,
/turf/open/floor/plating,
/area/shuttle/arrival)
"m" = (
/obj/structure/closet/firecloset,
/turf/open/floor/mineral/titanium,
/area/shuttle/arrival)
"o" = (
/obj/machinery/light{
	dir = 4
	},
/turf/open/floor/mineral/titanium,
/area/shuttle/arrival)
"w" = (
/obj/docking_port/mobile/arrivals{
	dir = 1;
	dwidth = 4;
	height = 11;
	name = "deca arrivals shuttle";
	width = 9
	},
/turf/closed/wall/mineral/plastitanium,
/area/shuttle/arrival)
"C" = (
/turf/closed/wall/mineral/plastitanium,
/area/shuttle/arrival)
"D" = (
/turf/closed/wall/mineral/titanium,
/area/shuttle/arrival)
"G" = (
/obj/structure/closet/emcloset/anchored,
/turf/open/floor/mineral/titanium,
/area/shuttle/arrival)
"K" = (
/obj/structure/sign/nanotrasen,
/turf/closed/wall/mineral/titanium,
/area/shuttle/arrival)
"M" = (
/obj/machinery/requests_console{
	department = "Arrival shuttle";
	name = "Arrivals Shuttle console";
	pixel_x = 32
	},
/turf/open/floor/mineral/titanium,
/area/shuttle/arrival)
"N" = (
/obj/structure/chair/comfy/shuttle{
	dir = 1
	},
/turf/open/floor/mineral/titanium/yellow,
/area/shuttle/arrival)
"P" = (
/obj/structure/shuttle/engine/propulsion,
/turf/open/floor/plating,
/area/shuttle/arrival)
"T" = (
/obj/structure/chair/comfy/shuttle,
/turf/open/floor/mineral/titanium/yellow,
/area/shuttle/arrival)
"V" = (
/obj/structure/closet/crate/medical,
/obj/effect/turf_decal/stripes/line{
	dir = 5
	},
/turf/open/floor/mineral/plastitanium,
/area/shuttle/arrival)
"W" = (
/obj/machinery/computer,
/turf/open/floor/mineral/titanium/blue,
/area/shuttle/arrival)
"X" = (
/obj/structure/chair/comfy/shuttle{
	dir = 1
	},
/turf/open/floor/mineral/titanium/blue,
/area/shuttle/arrival)
"Y" = (
/turf/open/floor/mineral/titanium,
/area/shuttle/arrival)

(1,1,1) = {"
a
D
D
d
K
d
D
l
D
C
a
"}
(2,1,1) = {"
l
D
G
Y
k
Y
Y
Y
V
h
P
"}
(3,1,1) = {"
l
W
X
Y
N
l
N
Y
N
h
P
"}
(4,1,1) = {"
l
W
X
Y
N
D
T
Y
N
C
w
"}
(5,1,1) = {"
l
W
X
Y
N
l
T
Y
N
h
P
"}
(6,1,1) = {"
l
D
m
Y
o
Y
M
Y
e
h
P
"}
(7,1,1) = {"
a
D
D
l
K
l
D
l
D
C
a
"}
