//MAP CONVERTED BY dmm2tgm.py THIS HEADER COMMENT PREVENTS RECONVERSION, DO NOT REMOVE
"a" = (
/turf/template_noop,
/area/template_noop)
"b" = (
/turf/closed/wall/mineral/cult,
/area/shuttle/arrival)
"c" = (
/obj/structure/fans/tiny,
/obj/machinery/door/airlock/cult/friendly,
/turf/open/floor/plating/rust,
/area/shuttle/arrival)
"d" = (
/obj/effect/spawner/structure/window/hollow/survival_pod/end{
	dir = 8
	},
/turf/open/floor/plating,
/area/shuttle/arrival)
"f" = (
/obj/structure/stone_tile/block/cracked,
/obj/effect/decal/cleanable/blood/tracks{
	dir = 9
	},
/obj/effect/decal/cleanable/blood/drip,
/obj/effect/decal/cleanable/blood/footprints{
	dir = 8
	},
/turf/open/floor/plasteel/cult,
/area/shuttle/arrival)
"g" = (
/obj/machinery/light{
	bulb_colour = "#990000";
	dir = 1
	},
/obj/effect/decal/cleanable/blood/tracks{
	dir = 8
	},
/obj/effect/decal/cleanable/blood/drip,
/obj/effect/decal/cleanable/blood/footprints{
	dir = 8
	},
/turf/open/floor/plating/rust,
/area/shuttle/arrival)
"i" = (
/obj/effect/decal/cleanable/dirt/dust,
/obj/structure/stone_tile/block/cracked,
/obj/effect/decal/cleanable/blood/tracks{
	dir = 8
	},
/obj/effect/decal/cleanable/blood/drip,
/obj/effect/decal/cleanable/blood/footprints{
	dir = 8
	},
/turf/open/floor/plasteel/cult,
/area/shuttle/arrival)
"j" = (
/obj/structure/stone_tile/block/cracked,
/obj/effect/decal/cleanable/blood/tracks{
	dir = 8
	},
/obj/effect/decal/cleanable/blood/drip,
/obj/effect/decal/cleanable/blood/footprints{
	dir = 8
	},
/turf/open/floor/plasteel/cult,
/area/shuttle/arrival)
"k" = (
/obj/effect/decal/cleanable/blood/tracks{
	dir = 8
	},
/obj/effect/decal/cleanable/blood/drip,
/obj/effect/decal/cleanable/blood/footprints{
	dir = 8
	},
/turf/open/floor/plating/rust,
/area/shuttle/arrival)
"l" = (
/obj/machinery/requests_console{
	department = "Arrival shuttle";
	name = "Arrivals Shuttle console";
	pixel_y = 30
	},
/obj/machinery/light{
	bulb_colour = "#990000";
	dir = 1
	},
/obj/effect/decal/cleanable/blood/tracks{
	dir = 8
	},
/obj/effect/decal/cleanable/blood/drip,
/obj/effect/decal/cleanable/blood/drip,
/obj/effect/decal/cleanable/blood/footprints{
	dir = 8
	},
/turf/open/floor/plating/rust,
/area/shuttle/arrival)
"m" = (
/obj/structure/shuttle/engine/heater{
	dir = 4
	},
/obj/structure/window/reinforced{
	dir = 8
	},
/turf/open/floor/plating/airless,
/area/shuttle/arrival)
"n" = (
/obj/structure/shuttle/engine/propulsion/burst/right{
	dir = 4
	},
/turf/open/floor/plating/airless,
/area/shuttle/arrival)
"o" = (
/obj/effect/spawner/structure/window/hollow/survival_pod/end{
	dir = 1
	},
/turf/open/floor/plating,
/area/shuttle/arrival)
"p" = (
/obj/structure/stone_tile/surrounding/cracked,
/obj/structure/stone_tile/surrounding/cracked{
	dir = 1
	},
/obj/structure/stone_tile/center/cracked,
/turf/open/floor/plasteel/cult,
/area/shuttle/arrival)
"q" = (
/obj/effect/decal/cleanable/blood/gibs/body,
/turf/open/floor/plating/rust,
/area/shuttle/arrival)
"r" = (
/obj/effect/decal/cleanable/blood/tracks{
	dir = 1
	},
/obj/effect/decal/cleanable/blood/drip,
/turf/open/floor/plasteel/cult,
/area/shuttle/arrival)
"s" = (
/obj/structure/shuttle/engine/propulsion{
	dir = 4
	},
/turf/open/floor/plating/airless,
/area/shuttle/arrival)
"t" = (
/obj/effect/decal/cleanable/dirt/dust,
/obj/structure/stone_tile/block/cracked{
	dir = 8
	},
/turf/open/floor/plasteel/cult,
/area/shuttle/arrival)
"u" = (
/obj/structure/shuttle/engine/propulsion{
	dir = 4
	},
/obj/docking_port/mobile/arrivals,
/turf/open/floor/plating/airless,
/area/shuttle/arrival)
"v" = (
/obj/effect/decal/cleanable/blood/splatter,
/obj/effect/decal/cleanable/blood/drip,
/turf/open/floor/plating/rust,
/area/shuttle/arrival)
"w" = (
/obj/effect/decal/cleanable/blood/gibs,
/obj/effect/decal/cleanable/blood/gibs/limb,
/turf/open/floor/plating/rust,
/area/shuttle/arrival)
"x" = (
/obj/structure/destructible/cult/pylon,
/obj/structure/stone_tile/surrounding/cracked{
	dir = 1
	},
/obj/structure/stone_tile/surrounding/cracked,
/obj/structure/stone_tile/center/cracked,
/turf/open/floor/plasteel/cult,
/area/shuttle/arrival)
"y" = (
/obj/machinery/light{
	bulb_colour = "#990000"
	},
/obj/effect/decal/cleanable/blood/gibs,
/turf/open/floor/plating/rust,
/area/shuttle/arrival)
"z" = (
/obj/item/radio/intercom{
	name = "Station Intercom (General)";
	pixel_y = -29
	},
/obj/machinery/light{
	bulb_colour = "#990000"
	},
/obj/structure/stone_tile/block/cracked{
	dir = 1
	},
/turf/open/floor/plasteel/cult,
/area/shuttle/arrival)
"A" = (
/obj/structure/shuttle/engine/propulsion/burst/left{
	dir = 4
	},
/turf/open/floor/plating/airless,
/area/shuttle/arrival)
"B" = (
/obj/effect/decal/cleanable/blood/gibs/up,
/turf/open/floor/plating/rust,
/area/shuttle/arrival)
"C" = (
/obj/structure/stone_tile/block/cracked{
	dir = 8
	},
/turf/open/floor/plasteel/cult,
/area/shuttle/arrival)
"D" = (
/obj/structure/chair/comfy/shuttle{
	dir = 8
	},
/turf/open/floor/plating/rust,
/area/shuttle/arrival)
"E" = (
/obj/effect/decal/cleanable/dirt/dust,
/obj/structure/table/wood/fancy/orange,
/obj/item/toy/toy_dagger,
/turf/open/floor/plasteel/cult,
/area/shuttle/arrival)
"F" = (
/obj/effect/rune/narsie,
/obj/item/toy/plush/narplush/hugbox,
/turf/open/floor/plasteel/cult,
/area/shuttle/arrival)
"G" = (
/obj/effect/spawner/structure/window/hollow/survival_pod/middle,
/turf/open/floor/plating,
/area/shuttle/arrival)
"H" = (
/obj/effect/spawner/structure/window/hollow/survival_pod/end,
/turf/open/floor/plating,
/area/shuttle/arrival)
"I" = (
/obj/effect/decal/cleanable/dirt/dust,
/obj/structure/table/wood/fancy/orange,
/obj/item/reagent_containers/food/snacks/soup/blood{
	name = "Bowl of Blood";
	pixel_x = 1;
	pixel_y = 9
	},
/turf/open/floor/plasteel/cult,
/area/shuttle/arrival)
"J" = (
/obj/structure/chair/comfy/shuttle{
	dir = 8
	},
/turf/open/floor/plasteel/cult,
/area/shuttle/arrival)
"K" = (
/obj/structure/chair/comfy/shuttle{
	dir = 8
	},
/obj/effect/decal/cleanable/dirt/dust,
/turf/open/floor/plasteel/cult,
/area/shuttle/arrival)
"L" = (
/obj/effect/spawner/structure/window/hollow/survival_pod/middle{
	dir = 4
	},
/turf/open/floor/plating,
/area/shuttle/arrival)
"M" = (
/obj/structure/fans/tiny,
/obj/effect/decal/cleanable/blood/tracks{
	dir = 1
	},
/obj/machinery/door/airlock/cult/friendly,
/obj/effect/decal/cleanable/blood/drip,
/turf/open/floor/plating/rust,
/area/shuttle/arrival)
"N" = (
/obj/effect/decal/cleanable/blood/gibs,
/turf/open/floor/plasteel/cult,
/area/shuttle/arrival)
"O" = (
/turf/open/floor/plating/rust,
/area/shuttle/arrival)
"P" = (
/obj/effect/decal/cleanable/blood/gibs,
/obj/effect/decal/cleanable/blood/tracks{
	dir = 5
	},
/turf/open/floor/plating/rust,
/area/shuttle/arrival)
"Q" = (
/obj/structure/stone_tile/surrounding_tile/cracked{
	dir = 4
	},
/obj/effect/clockwork/overlay/floor/bloodcult,
/turf/open/floor/plasteel/cult,
/area/shuttle/arrival)
"R" = (
/obj/structure/stone_tile/block/cracked{
	dir = 4
	},
/turf/open/floor/plasteel/cult,
/area/shuttle/arrival)
"S" = (
/obj/structure/table/wood/fancy/orange,
/obj/item/clothing/head/helmet/skull,
/turf/open/floor/plasteel/cult,
/area/shuttle/arrival)
"T" = (
/obj/effect/decal/cleanable/dirt/dust,
/turf/open/floor/plasteel/cult,
/area/shuttle/arrival)
"U" = (
/obj/structure/stone_tile/center/cracked,
/obj/structure/stone_tile/surrounding/cracked{
	dir = 1
	},
/obj/structure/stone_tile/surrounding/cracked,
/obj/effect/decal/cleanable/blood/splatter,
/turf/open/floor/plasteel/cult,
/area/shuttle/arrival)
"V" = (
/obj/effect/decal/cleanable/blood/tracks{
	dir = 6
	},
/obj/effect/decal/cleanable/blood/drip,
/turf/open/floor/plating/rust,
/area/shuttle/arrival)
"W" = (
/turf/open/floor/plasteel/cult,
/area/shuttle/arrival)
"X" = (
/obj/structure/stone_tile/block/cracked{
	dir = 1
	},
/turf/open/floor/plasteel/cult,
/area/shuttle/arrival)
"Y" = (
/turf/closed/wall/rust,
/area/shuttle/arrival)
"Z" = (
/obj/effect/spawner/structure/window/hollow/survival_pod/end{
	dir = 4
	},
/turf/open/floor/plating,
/area/shuttle/arrival)

(1,1,1) = {"
a
b
o
L
H
Y
a
"}
(2,1,1) = {"
a
b
p
R
v
Y
a
"}
(3,1,1) = {"
a
b
q
F
w
Y
a
"}
(4,1,1) = {"
b
b
p
t
U
Y
Y
"}
(5,1,1) = {"
b
x
S
I
E
x
Y
"}
(6,1,1) = {"
c
f
r
B
W
O
c
"}
(7,1,1) = {"
Y
g
W
W
q
y
b
"}
(8,1,1) = {"
d
k
J
N
D
Q
d
"}
(9,1,1) = {"
G
i
O
O
T
X
G
"}
(10,1,1) = {"
G
j
K
O
K
X
G
"}
(11,1,1) = {"
Z
k
O
W
W
X
Z
"}
(12,1,1) = {"
Y
l
J
O
J
z
b
"}
(13,1,1) = {"
M
V
C
C
O
P
c
"}
(14,1,1) = {"
b
m
m
m
m
m
Y
"}
(15,1,1) = {"
b
n
s
u
s
A
Y
"}
