//MAP CONVERTED BY dmm2tgm.py THIS HEADER COMMENT PREVENTS RECONVERSION, DO NOT REMOVE
"aa" = (
/turf/template_noop,
/area/template_noop)
"ac" = (
/obj/structure/chair/comfy/shuttle{
	dir = 1
	},
/turf/open/floor/mineral/titanium/blue,
/area/shuttle/escape)
"ad" = (
/turf/closed/wall/mineral/titanium,
/area/shuttle/escape)
"ae" = (
/obj/structure/table,
/obj/machinery/recharger,
/turf/open/floor/mineral/titanium/blue,
/area/shuttle/escape)
"af" = (
/obj/machinery/computer/communications,
/turf/open/floor/mineral/titanium/blue,
/area/shuttle/escape)
"ag" = (
/obj/machinery/computer/security{
	dir = 8
	},
/turf/open/floor/mineral/titanium/blue,
/area/shuttle/escape)
"ah" = (
/obj/machinery/computer/crew{
	dir = 4
	},
/turf/open/floor/mineral/titanium/blue,
/area/shuttle/escape)
"ai" = (
/obj/machinery/light,
/obj/item/radio/intercom{
	name = "Station Intercom (General)";
	pixel_y = -29
	},
/turf/open/floor/mineral/titanium,
/area/shuttle/escape)
"al" = (
/obj/machinery/button/flasher{
	id = "cockpit_flasher";
	pixel_x = 6;
	pixel_y = -24
	},
/turf/open/floor/mineral/titanium,
/area/shuttle/escape)
"am" = (
/obj/machinery/computer/station_alert{
	dir = 8
	},
/turf/open/floor/mineral/titanium/blue,
/area/shuttle/escape)
"an" = (
/obj/structure/table,
/obj/item/storage/firstaid/regular{
	pixel_x = 2;
	pixel_y = 3
	},
/obj/item/crowbar,
/obj/item/storage/firstaid/fire,
/turf/open/floor/mineral/titanium/blue,
/area/shuttle/escape)
"ap" = (
/obj/structure/chair/comfy/shuttle,
/obj/machinery/flasher{
	id = "cockpit_flasher";
	pixel_x = 6;
	pixel_y = 24
	},
/turf/open/floor/mineral/titanium/blue,
/area/shuttle/escape)
"aq" = (
/obj/structure/closet/emcloset,
/turf/open/floor/mineral/titanium/blue,
/area/shuttle/escape)
"ar" = (
/obj/machinery/light/small{
	dir = 4
	},
/turf/open/floor/mineral/titanium/blue,
/area/shuttle/escape)
"as" = (
/obj/structure/chair/comfy/shuttle{
	dir = 1
	},
/obj/structure/window/reinforced,
/turf/open/floor/mineral/titanium/blue,
/area/shuttle/escape)
"at" = (
/obj/machinery/light,
/turf/open/floor/mineral/titanium,
/area/shuttle/escape)
"au" = (
/obj/structure/chair/comfy/shuttle,
/obj/structure/window/reinforced{
	dir = 1;
	layer = 2.9
	},
/turf/open/floor/mineral/titanium/blue,
/area/shuttle/escape)
"az" = (
/obj/structure/extinguisher_cabinet{
	pixel_x = 27
	},
/turf/open/floor/mineral/titanium,
/area/shuttle/escape)
"aB" = (
/obj/machinery/computer/emergency_shuttle,
/turf/open/floor/mineral/titanium/blue,
/area/shuttle/escape)
"aC" = (
/turf/open/floor/mineral/titanium,
/area/shuttle/escape)
"aE" = (
/turf/closed/wall/mineral/titanium/interior,
/area/shuttle/escape)
"aF" = (
/obj/machinery/computer/atmos_alert{
	dir = 4
	},
/turf/open/floor/mineral/titanium/blue,
/area/shuttle/escape)
"aJ" = (
/obj/structure/chair/comfy/shuttle{
	dir = 8
	},
/obj/structure/extinguisher_cabinet{
	pixel_y = -30
	},
/turf/open/floor/mineral/titanium/blue,
/area/shuttle/escape)
"aK" = (
/turf/open/floor/mineral/plastitanium/red/brig,
/area/shuttle/escape)
"aM" = (
/obj/structure/chair/comfy/shuttle{
	dir = 4
	},
/turf/open/floor/mineral/titanium/blue,
/area/shuttle/escape)
"aR" = (
/obj/machinery/light/small{
	dir = 4
	},
/obj/structure/chair/comfy/shuttle{
	dir = 8
	},
/turf/open/floor/mineral/plastitanium/red/brig,
/area/shuttle/escape)
"aS" = (
/obj/structure/table,
/turf/open/floor/mineral/titanium/blue,
/area/shuttle/escape)
"aT" = (
/obj/structure/chair/comfy/shuttle{
	dir = 8
	},
/turf/open/floor/mineral/titanium/blue,
/area/shuttle/escape)
"aW" = (
/obj/machinery/door/airlock/public/glass{
	name = "Emergency Shuttle Brig";
	req_access_txt = "2"
	},
/obj/machinery/door/firedoor/border_only{
	dir = 4
	},
/obj/machinery/door/firedoor/border_only{
	dir = 8
	},
/turf/open/floor/mineral/titanium,
/area/shuttle/escape)
"bb" = (
/turf/open/floor/mineral/titanium/yellow,
/area/shuttle/escape)
"bc" = (
/obj/item/clothing/suit/hazardvest{
	desc = "A high-visibility lifejacket complete with whistle and slot for oxygen tanks.";
	name = "emergency lifejacket"
	},
/obj/item/clothing/suit/hazardvest{
	desc = "A high-visibility lifejacket complete with whistle and slot for oxygen tanks.";
	name = "emergency lifejacket"
	},
/obj/item/clothing/suit/hazardvest{
	desc = "A high-visibility lifejacket complete with whistle and slot for oxygen tanks.";
	name = "emergency lifejacket"
	},
/obj/item/clothing/suit/hazardvest{
	desc = "A high-visibility lifejacket complete with whistle and slot for oxygen tanks.";
	name = "emergency lifejacket"
	},
/obj/item/clothing/suit/hazardvest{
	desc = "A high-visibility lifejacket complete with whistle and slot for oxygen tanks.";
	name = "emergency lifejacket"
	},
/obj/item/tank/internals/emergency_oxygen{
	pixel_x = 3
	},
/obj/item/tank/internals/emergency_oxygen{
	pixel_x = 3
	},
/obj/item/tank/internals/emergency_oxygen{
	pixel_x = 3
	},
/obj/item/tank/internals/emergency_oxygen{
	pixel_x = 3
	},
/obj/item/tank/internals/emergency_oxygen{
	pixel_x = 3
	},
/obj/item/clothing/mask/breath{
	pixel_x = -3;
	pixel_y = -3
	},
/obj/item/clothing/mask/breath{
	pixel_x = -3;
	pixel_y = -3
	},
/obj/item/clothing/mask/breath{
	pixel_x = -3;
	pixel_y = -3
	},
/obj/item/clothing/mask/breath{
	pixel_x = -3;
	pixel_y = -3
	},
/obj/item/clothing/mask/breath{
	pixel_x = -3;
	pixel_y = -3
	},
/obj/item/clothing/head/hardhat/orange{
	name = "protective hat";
	pixel_y = 9
	},
/obj/item/clothing/head/hardhat/orange{
	name = "protective hat";
	pixel_y = 9
	},
/obj/item/clothing/head/hardhat/orange{
	name = "protective hat";
	pixel_y = 9
	},
/obj/item/clothing/head/hardhat/orange{
	name = "protective hat";
	pixel_y = 9
	},
/obj/item/clothing/head/hardhat/orange{
	name = "protective hat";
	pixel_y = 9
	},
/obj/structure/closet/crate{
	name = "lifejackets"
	},
/turf/open/floor/mineral/titanium/yellow,
/area/shuttle/escape)
"bd" = (
/obj/structure/chair/comfy/shuttle{
	dir = 8
	},
/obj/machinery/button/flasher{
	id = "shuttle_flasher";
	pixel_x = 24;
	pixel_y = -6
	},
/obj/machinery/flasher{
	id = "shuttle_flasher";
	pixel_x = 24;
	pixel_y = 6
	},
/turf/open/floor/mineral/plastitanium/red/brig,
/area/shuttle/escape)
"be" = (
/obj/structure/extinguisher_cabinet{
	pixel_x = 27
	},
/obj/structure/chair/comfy/shuttle{
	dir = 8
	},
/turf/open/floor/mineral/plastitanium/red/brig,
/area/shuttle/escape)
"bf" = (
/obj/structure/extinguisher_cabinet{
	pixel_y = 32
	},
/turf/open/floor/mineral/titanium/yellow,
/area/shuttle/escape)
"bg" = (
/obj/structure/rack,
/obj/item/storage/toolbox/emergency{
	pixel_x = 3;
	pixel_y = -5
	},
/obj/item/crowbar,
/obj/item/wrench,
/obj/item/radio,
/turf/open/floor/mineral/titanium/yellow,
/area/shuttle/escape)
"bi" = (
/obj/structure/window/reinforced{
	dir = 1
	},
/obj/structure/shuttle/engine/heater,
/turf/open/floor/plating/airless,
/area/shuttle/escape)
"bj" = (
/obj/machinery/stasis,
/turf/open/floor/mineral/titanium/white,
/area/shuttle/escape)
"bk" = (
/obj/structure/shuttle/engine/propulsion,
/turf/open/floor/plating/airless,
/area/shuttle/escape)
"bl" = (
/obj/structure/table,
/obj/item/storage/firstaid/fire,
/obj/item/storage/firstaid/regular{
	pixel_x = 2;
	pixel_y = 3
	},
/obj/item/crowbar,
/obj/structure/extinguisher_cabinet{
	pixel_x = 27
	},
/obj/machinery/light/small{
	dir = 4
	},
/turf/open/floor/mineral/titanium/white,
/area/shuttle/escape)
"bm" = (
/obj/machinery/door/airlock/public/glass{
	name = "Emergency Shuttle Cockpit";
	req_access_txt = "19"
	},
/obj/machinery/door/firedoor/border_only{
	dir = 1
	},
/obj/machinery/door/firedoor/border_only,
/turf/open/floor/mineral/titanium,
/area/shuttle/escape)
"bn" = (
/obj/structure/chair/comfy/shuttle,
/turf/open/floor/mineral/titanium/blue,
/area/shuttle/escape)
"bo" = (
/obj/machinery/light/small{
	brightness = 3;
	dir = 8
	},
/turf/open/floor/mineral/titanium,
/area/shuttle/escape)
"bp" = (
/obj/structure/rack,
/obj/item/tank/internals/oxygen/red,
/obj/item/clothing/suit/fire/firefighter,
/obj/item/clothing/mask/gas,
/obj/item/clothing/head/hardhat/red,
/turf/open/floor/mineral/titanium/yellow,
/area/shuttle/escape)
"bq" = (
/obj/machinery/light/small{
	brightness = 3;
	dir = 8
	},
/turf/open/floor/mineral/titanium/yellow,
/area/shuttle/escape)
"bs" = (
/obj/machinery/door/airlock/public/glass{
	name = "Emergency Shuttle Infirmary"
	},
/obj/machinery/door/firedoor/border_only,
/obj/machinery/door/firedoor/border_only{
	dir = 1
	},
/turf/open/floor/mineral/titanium/white,
/area/shuttle/escape)
"ga" = (
/turf/open/floor/mineral/titanium/white,
/area/shuttle/escape)
"mA" = (
/obj/machinery/door/airlock/titanium{
	name = "Emergency Shuttle Airlock"
	},
/obj/structure/fans/tiny,
/turf/open/floor/plating,
/area/shuttle/escape)
"BZ" = (
/turf/closed/wall/mineral/titanium/nodiagonal,
/area/shuttle/escape)
"Dd" = (
/obj/machinery/door/airlock/titanium{
	name = "Emergency Shuttle Cargo"
	},
/obj/machinery/door/firedoor/border_only,
/obj/machinery/door/firedoor/border_only{
	dir = 1
	},
/turf/open/floor/mineral/titanium/blue,
/area/shuttle/escape)
"JW" = (
/obj/effect/spawner/structure/window/shuttle,
/obj/machinery/door/firedoor/window,
/turf/open/floor/plating,
/area/shuttle/escape)
"Km" = (
/obj/docking_port/mobile/emergency{
	name = "Orbital emergency shuttle"
	},
/turf/closed/wall/mineral/titanium,
/area/shuttle/escape)
"Lm" = (
/obj/machinery/vending/wallmed{
	name = "Emergency NanoMed";
	use_power = 0
	},
/turf/closed/wall/mineral/titanium,
/area/shuttle/escape)
"XC" = (
/obj/effect/spawner/structure/window/shuttle,
/turf/open/floor/plating,
/area/shuttle/escape)

(1,1,1) = {"
aa
aE
ad
JW
ad
Km
JW
JW
JW
JW
ad
ad
ad
mA
ad
mA
ad
ad
"}
(2,1,1) = {"
aE
aE
aF
ah
ad
bn
bo
as
au
bo
as
bo
ad
bb
bq
bb
bi
bk
"}
(3,1,1) = {"
JW
ae
aT
aJ
ad
bn
aC
as
au
aC
as
aC
ad
bf
bb
bb
bi
bk
"}
(4,1,1) = {"
JW
ac
aC
ai
ad
bn
aC
as
au
aC
as
aC
Dd
bb
bb
bb
bi
bk
"}
(5,1,1) = {"
JW
af
aC
al
ad
ap
aC
as
au
aC
as
aC
ad
bc
bb
bg
bi
bk
"}
(6,1,1) = {"
JW
aB
aC
aC
bm
aC
aC
aC
az
aC
aC
aC
ad
bc
bb
bp
bi
bk
"}
(7,1,1) = {"
JW
ac
aC
at
ad
aS
aS
aC
BZ
XC
aW
XC
ad
XC
bs
XC
bi
bk
"}
(8,1,1) = {"
JW
an
aM
aM
ad
aT
aT
aC
ad
aK
aK
aK
Lm
ga
ga
ga
bi
bk
"}
(9,1,1) = {"
ad
aE
ag
am
ad
aq
ar
aC
ad
aR
bd
be
ad
bj
bl
bj
bi
bk
"}
(10,1,1) = {"
aa
aE
ad
JW
ad
ad
JW
JW
ad
ad
ad
ad
ad
JW
ad
JW
ad
ad
"}
